111111111111111111111111111111
1P011111C011C001000C0100001111
110000000001110100100001100011
110111011C000100000011Y1C01011
11Y0000000Y0C00010111001100YC1
111001111111000000111110111001
10001100C0000001Y0C00000000Y01
110100010111110001011110100101
11010111010100Y00000000011C1C1
11010000110101111000110Y100111
1C0000001001110000111011100C11
11Y1011Y0000C000101C00001Y1111
1C0101011111110110110111101001
111101000100010C010100C1000001
100001000011011110010111011Y01
1001100100C100000001Y00001C011
10C00001110000C0CYC00Y000000E1
111111111111111111111111111111